NO ./test_1.xpm
SO ./test_3.xpm
WE ./test_2.xpm
EA ./test_4.xpm

F 220,100,0
C 225,30,0
1111111111D111111
10000000000000001
1000B000000000001
1000000000111111
100N00111111
1110111
111D111
1110111
1000001
1000001
1000001
1000001
1111111