NO ./mandatory/sprites/test_1.xpm
SO ./mandatory/sprites/test_3.xpm

WE ./mandatory/sprites/test_2.xpm
EA ./mandatory/sprites/test_4.xpm

F 102,100,100
C 10,25,255
1111111111111111
100000000000000E1
10000000000000001
1000000000111111
100000111111
11101111
1110111
1110111
1000001
1000001
1000001
1000001
1111111
