NO ./sprites/test_1.xpm
SO ./sprites/test_3.xpm
WE ./sprites/test_2.xpm
EsA ./sprites/test_4.xpm

F 102,100,100
C 10,20,250
11111111111111111
10000000000000001
10000000000000001
1000000000111111
100000111111
11101111
1110111
1110111
1000001
100N001
1000001
1000001
1111111
