




NO ./bonus/sprites/test_1.xpm

F 102,100,100

C 10,20,250


SO ./bonus/sprites/test_3.xpm


WE ./bonus/sprites/test_2.xpm



EA ./bonus/sprites/test_4.xpm











111111111111111
100000000000001
10B00000100N001
100000000111111
100000111111
111D1111
1110111
1110111
1000001
1000001
1000001
1000001
1111111