NO ./test_1.xpm
SO ./test_3.xpm
WE ./test_2.xpm
EA ./test_4.xpm

F 102,100,100
C 10,20,250
1111111111D111111
10000000000000001
1000B000D0000000D
1000000000111111
100E00111111
111D111
1110111
1110111
1000001
1000001
1000001
1000001
1111D11
